Member	Currency
USA	USD
Kanada	USD
Brasilien	USD
Uruguay	USD
Argentinien	USD
Chile	USD
Mexiko	USD
Deutschland	EUR
Frankreich	EUR
D�nemark	EUR
Norwegen	EUR
Schweden	EUR
Finnland	EUR
Belgien	EUR
Luxemburg	EUR
Niederlande	EUR
Gro�britannien	EUR
Irland	EUR
Island	EUR
Schweiz	EUR
Liechtenstein	EUR
�sterreich	EUR
Italien	EUR
Spanien	EUR
Portugal	EUR
Griechenland	EUR
T�rkei	EUR
Polen	EUR
Bulgarien	EUR
Rum�nien	EUR
Ungarn	EUR
Slowakei	EUR
Tschechische Republik	EUR
